[
  {
    "levelNumber": 1,
    "mapGrid": [
      "###################################################",
      "#.....>#......#.....................#.............#",
      "#..#####......#..#####..............#.............#",
      "#..#...#......#..#...#..............#.............#",
      "#..#...+......#+##...#..............#.............#",
      "#..#...#.........#...#..............#.............#",
      "#..#####.........##+##..............#####.........#",
      "#...................................#.............#",
      "#..#####..............#####.........#.............#",
      "#..#...#..............#...#.........#.............#",
      "#..#...+..............+...#.........#.............#",
      "#..#...#..............#...#.........#.............#",
      "#..#####..............#####.........#####.........#",
      "#.................................................#",
      "#.................................................#",
      "#.................................................#",
      "#.................................................#",
      "#.................................................#",
      "#.................................................#",
      "#.................................................#",
      "#.................................................#",
      "#.................................................#",
      "#.................................................#",
      "#.................................................#",
      "#.............#................................#..#",
      "#.............#................................#..#",
      "###################################################"
    ],
    "monsters": [
      { "name": "Goblin", "position": [5, 5], "health": 10 },
      { "name": "Skeleton", "position": [10, 15], "health": 12 },
      { "name": "Zombie", "position": [8, 18], "health": 15 },
      { "name": "Slime", "position": [12, 25], "health": 5 }
    ],
    "items": [
      { "itemName": "Health Potion", "itemPosition": [6, 5], "itemDescription": "Restores 20 HP.", "itemCategory": "Healing", "itemEffectValue": 60 },
      { "itemName": "Sword", "itemPosition": [11, 20], "itemDescription": "A sharp blade.", "itemCategory": "Weapon", "itemEffectValue": 15 },
      { "itemName": "Gold Coin", "itemPosition": [8, 25], "itemDescription": "Shiny and valuable.", "itemCategory": "Special", "itemEffectValue": 0 }
    ]
  },
  {
    "levelNumber": 2,
    "mapGrid": [
      "################################################## ",
      "#....#<.......#...............#..................# ",
      "#..##########.#.######........#..................# ",
      "#..#...#......#.#....#........#..................# ",
      "#..#...+.....##+###..##.......#..................# ",
      "#..#...#..........#...#.......#..................##",
      "#..#####..........#.###.......#...................#",
      "#.................#.#.............................#",
      "#..################.#######.....#####.............#",
      "#..#......................#######...#.............#",
      "#..#...################...+.....+...+.............#",
      "#..#...#..............#...#######...#.............#",
      "#..#####..............#####.....#####.............#",
      "#.................................................#",
      "#.................................................#",
      "#.................................................#",
      "#.................................................#",
      "#.................................................#",
      "#.................................................#",
      "#.................................................#",
      "#.................................................#",
      "#.................................................#",
      "#.................................................#",
      "#.................................................#",
      "#.................................................#",
      "#.............>...................................#",
      "###################################################"
    ],
    "monsters": [
      { "name": "Orc", "position": [7, 7], "health": 18 },
      { "name": "Bat", "position": [15, 20], "health": 8 },
      { "name": "Slime", "position": [10, 9], "health": 5 },
      { "name": "Wraith", "position": [18, 25], "health": 20 }
    ],
    "items": [
      { "itemName": "Shield", "itemPosition": [9, 9], "itemDescription": "A protective shield.", "itemCategory": "Armor", "itemEffectValue": 10 },
      { "itemName": "Magic Scroll", "itemPosition": [20, 15], "itemDescription": "Contains a spell.", "itemCategory": "Special", "itemEffectValue": 0 },
      { "itemName": "Amulet", "itemPosition": [12, 25], "itemDescription": "Grants protection.", "itemCategory": "Armor", "itemEffectValue": 5 }
    ]
  },
  {
    "levelNumber": 3,
    "mapGrid": [
      "###################################################",
      "#.............#...................#...............#",
      "#..#####......#..#####............#...............#",
      "#..#...#......#..#...#............#...............#",
      "#..#...+......#+###..#............#...............#",
      "#..#...#......#.#.#...#...........#...............#",
      "#..#####.######.#.#####...........#####...........#",
      "#...............#.................................#",
      "#..#####...######.....#####.......#####...........#",
      "#..#...##+##..........#...#.......#...#...........#",
      "#..#...+.....#####....+...........#...+...........#",
      "#..#>#.#######...######...#.......#...#...........#",
      "#..#####..............#####.......#####...........#",
      "#.................................................#",
      "#.................................................#",
      "#.................................................#",
      "#.................................................#",
      "#.................................................#",
      "#.................................................#",
      "#.................................................#",
      "#.................................................#",
      "#.................................................#",
      "#.................................................#",
      "#.................................................#",
      "#.................................................#",
      "#.............<...................................#",
      "###################################################"
    ],
    "monsters": [
      { "name": "Dragon", "position": [25, 25], "health": 100 },
      { "name": "Snake", "position": [18, 12], "health": 20 },
      { "name": "Lich", "position": [22, 22], "health": 50 }
    ],
    "items": [
      { "itemName": "Ring of Power", "itemPosition": [10, 10], "itemDescription": "Grants strength.", "itemCategory": "Weapon", "itemEffectValue": 25 },
      { "itemName": "Potion of Flight", "itemPosition": [15, 15], "itemDescription": "Grants temporary flight.", "itemCategory": "Special", "itemEffectValue": 0 }
    ]
  },
  {
    "levelNumber": 4,
    "mapGrid": [
      "###################################################",
      "#.............#..#..#.............#...............#",
      "#..#####......#..#..##............#...............#",
      "#..#...#......#..##..#............#...............#",
      "#..#...+..........+..##...........#...............#",
      "#..#...#..........#...#...........#...............#",
      "#..#####..........#####...........#####...........#",
      "#.................................................#",
      "#..#####..............#####.......#####...........#",
      "#..#...#..............#...#...#####...#...........#",
      "#..#...+..............+...#..##...#...+...........#",
      "#..#<..#..............#...#.......#...#...........#",
      "#..#####..............###+#######.#####...........#",
      "#.......................#.........................#",
      "#.......................#.........................#",
      "#.......................#.........................#",
      "#.......................#.........................#",
      "#.......................#.........................#",
      "#.......................#.........................#",
      "#.......................#.........................#",
      "#.......................#.........................#",
      "#.......................#.........................#",
      "#.......................#.........................#",
      "#.......................#.........................#",
      "#.......................#.........................#",
      "#.......................#.........................#",
      "###################################################"
    ],
    "monsters": [
      { "name": "Demon", "position": [12, 12], "health": 60 }
    ],
    "items": [
      { "itemName": "Orb of Power", "itemPosition": [10, 10], "itemDescription": "Grants immense power.", "itemCategory": "Weapon", "itemEffectValue": 40 }
    ]
  }
]
